________  _______ 
| _____|  |   | |
| |______ | | | |
|______ | __| | |
|____ |   | ____|
|__ | |_| |___| |
  | |______ ____|
| |___ __| | __ |
|_____|___|___|_|
